C 255,0,0
F 129,234,244

NO ./textures/red.xpm
SO ./textures/red.xpm
EA ./textures/eagle.xpm

WE ./textures/red.xpm

11111111111111111111111111111
10000000000000000000000000001
10111111111110000000000000001
10000000000010000000000000001
1000000000001S000000000000001
10000000000000000000000000001
10000000000000000000000000001
10000000000000000000000000001
11111111111111111111111111111
